X                  X
X                  X
X             MMMMMX
X                  X
X   xxxxxxxxxxxxxxxX
X                  X
X                  X
Xxxxxxxxxxxxxxx    X
X                  X
X                  X
X    xxxxxxxxxxxxxxX
X                  X
X                  X
Xxxxxxxxxxxxxxx    X
X                  X
X                  X
X   xxxxxxxxxxxxxxxX
X                P X
X                  X
XXXXXXXXXXXXXXXXXXXX