X                  X
XP                 X
X                s X
Xxxxxx             X
X               xxxX
X                  X
X       xxxxxx     X
X                  X
X M                X
Xxxxxxxx    xxxxxxxX
X                  X
X       xxxxx      X
X                  X
X               xxxX
X                  X
X       x          X
Xxxx               X
X                  X
X                m X
XXXXXXXXXXXXXXXXXXXX							




